###############
#      #      #
# ##       ## #
#    ##N##    #
# #  #NGN#  # #
#    #####    #
####       ####
#    #####    #
#      #      #############
# ###  #  ###             #
#      C      #######  #  #
# ##       ## ####### ### #
#  # ##### #  #######  #  #
#      #      #######     #
###########################
