###############
#      #      #
# ##       ## #
#    ## ##    #
# #  # G #  # #
#    #####    #
####       ####
#    #####    #
#      #      ######################
# ###  #  ###                      #
#             ################  #  #
# ##       ## ################ ### #
#  # ##### #  ################  #  #
#      #      ################     #
####################################
