###################
#        #        #
# ## ### # ### ## #
# ## ### # ### ## #
#                 #
# ## # ##### # ## #
#    #   #   #    #
#### ### # ### ####
NNN# #       # #
#### # ##N## # ####
#      #NGN#      #
#### # ##### # ####
NNN# #       # #
#### # ##### # ####
#        #        #
# ## ### # ### ## #
#  #     C     #  #
## # # ##### # # ##
#    #   #   #    #
# #####  #  ##### #
#                 #
###################
