###############
#      #      #
# ##       ## #
#    ## ##    #
# #  # G #  # #
#    #####    #
####       ####
#    #####    #
#      #      #
# ###  #  ### #
#      C      #
# ##       ## #
#  # ##### #  #
#      #      #
###############
