###############
#      #      #
# ##       ## #
#    ## ##    ######################
# #  # G #  #                 #    #
#    #####    #     #   # #####    #
####       ####     ##### #   #    #
#    #####    #     #              #
#      #      ######################
# ###  #  ###                      #
#      C      ## ##### ### ###  #  #
# ##       ## ##  #### ### ### ### #
#  # ##### #  ### ##     #  ##  #  #
#      #      ### #### #### ##     #
####################################
